4 4 4 4 4 4 4 4 4 4 4 4 4 4 4 4 4 4 4 4 4 4 4 4 4 4
4 4 4 4 4 4 4 4 4 4 4 4 4 4 4 4 4 4 4 4 4 4 4 4 4 4
4 4 4 4 4 4 4 4 4 4 4 4 4 4 4 4 4 4 4 4 4 4 4 4 4 4
4 4 4 4 4 4 4 4 3 1 1 1 1 1 1 1 1 1 1 2 4 4 4 4 4 4
4 4 4 4 4 4 4 4 5 1 1 1 1 1 1 1 1 1 1 6 4 4 4 4 4 4
